============================
=......==.........==.......=
=.====.==.========.==.====.=
=.====.==.========.==.====.=
=..........................=
===.==.=====.==.=====.==.===
  =.==.=====.==.=====.==.=
===.==.......==.......==.===
....==.......==.......==....   
===.=====.========.=====.===
  =.=====..........=====.=
  =......................=
  =.=====.===..==..=====.=
  =.=====.=      =.=====.=
  =.==    =      =....==.=  
  =.==.==.=      =.==.==.=
===.==.==.========.==.==.===
.......==..........==.......
===.========.==.========.===
  =.========.==.========.=
  =..........==..........=
  =.=====.========.=====.=
===.=====.========.=====.===
=..........................=
=.====.=====.==.=====.====.= 
=.====.=====.==.=====.====.=
=.====.==....==....==.====.=
=.====.==..======..==.====.=
=.====.==..===== =.==.====.=
=..........................=
============================

