      ================
      =..............=                     
      =.==.======.==.=
      =.==.======.==.=
      =.==...==...==.=
      =.====.==.====.=
=======.====.==.====.=======                    
........==........==.......= 
===.======.======.====== ===
===.======.======.====== ===
=.......==...==...==.......=
=.=====.====.==.====.=====.=
=.=====.====.==.====.=====.=
=....==..............==....=
====.====.===..===.====.====
====.====.=      =.====.====
..==......=      =......==..
=.==.====.=      =.====.==.= 
=....====.========.====....=
=.==.==..............==.==.=
=.==.==.============.==.==.=
=.==.==.============.==.==.=
=.==.==......==......==.==.=
====.=======.==.=======.====
====.=======.==.=======.====
=..........................=
=.==.==================.==.=
=.==.=                =.==.=
=.==.=                =.==.=
=....=                =....=
======                ======

