============================
=............==............=
=.====.=====.==.=====.====.=
=.====.=====.==.=====.====.=
=..........................=
=.====.==.========.==.====.=
=.====.==.========.==.====.=
=......==....==....==......=
======.=====.==.=====.======
     =.=====.==.=====.=
     =.==..........==.=
     =.==.===  === ==.= 
======.==.=      = ==.======
..........=      =..........
======.==.=      =.==.====== 
     =.==.========.==.=
     =.==..........==.=
     =.== ========.==.=
======.== ========.==.======
=............==............=
=.====.=====.==.=====.====.=
=.====.=====.==.=====.====.=
=...==................==...=
===.==.==.========.==.==.=== 
===.==.==.========.==.==.===
=......==....=.....==......=
=.==========.==.==========.=
=.==========.==.==========.=
=..........................=
============================

